00000001
00000000
00000000
00000003
00000000
40000000
00000000
00000020