01100100
00100000
10011000
01000010
00000100
00100000
00000100
01002010