00100000
00000001
01000000
11100000
00000011
00000000
10000001
00010200
