00000101
11010001
10011101
10200101
10110101
10110101
10010001
11111111
