00010000
00000000
00000010
00100001
00000100
00010001
00001000
10000020
