00000001
00000000
00000000
30000004
00000000
00000000
00000000
00000020