00000000
00111101
10000001
00000010
00010000
00000002
00001000
11110000
