00010000
00000010
11010101
00000010
00000000
00011010
10000001
00100200
