00000000
00000001
11000000
10000002
00000000
00000000
10000000
00000010