00000001
00000000
00001000
10000000
20000000
00010000
10000000
00000010