00000001
00000000
00001000
10000000
00000000
00010000
12000000
00000010