00000000
00000000
00000000
00000100
01000000
00000210
00100000
10000000