00000000
00000000
00000000
00000100
01200000
00000010
00100000
10000000