00010000
00000000
01001000
00100010
00020000
01000100
10020000
00000000
