00010000
00000000
01001000
00000010
00120000
01000100
10020000
00000000
