00010000
10000010
00100002
00010100
01000000
00000010
10000000
00100000
