01100000
01000100
00010010
00001010
00100000
11100000
00200011
11000100
