00000012
11111011
00010001
00100100
00001003
10000002
00010000
00040010
