00000020
11111111
00000000
00000000
00000000
00000000
00000000
00000000
